0000000000
11b1111011
0000000000
1101111111
0000000000
1111111111
0000000000
1101111111