0000000000
0000000000
0000b00000
0001010000
0010101000
0101010b00
1010101010
2