0000000000
1100111400
0000000000
1111b10011
0000000000
4000011100