0b01010101
0101010101
0000000000
1010101010
1010101010
101010b010
1010101010
1010101010
10b0101010