00000000000
1010001010
0101000101
10100010b0
0101000101
10b0001010
0101000101
1010001010