0000000000
0000000000
0000000000
0000000000
101111110b
0000000000
1101110111
0000000000

